######################################
# ........                           #
#   #################      ###########
#                                    #
#      #####     ##########          #
#          #     #                   #
#          #     ##########          #
#                                    #
######################################